26111141111141111114
27777737777737777773
27414737373737371113
27373737373737377773
27377777373777371473
27511117373711511373
27777777777777777773
21111473741473741113
00000373739373730000
00000373700073730000
00000373739373730000
00000373739373730000
21411573751573751113
27377777777777777773
27371111117114111173
27777777777773777773
27411111111173711113
27377777777773777773
27511117371115111173
27777777377777777783
21111111511111111115