21111114111111111114
28777773777777777773
27111115737371111173
27777777737377777773
27114111157511111113
27773777777777777773
21113711111111111473
27773777777777777373
27373721011113737373
27373729099993737373
27373721111113737373
27377777777777737773
27511111117111151173
27777777777777777773
21117111111171111113
27777777777777777773
27111111111471111173
27777777777377777773
21111111117511111173
67777777777777777773
11111111111111111115