21111111111111111114
27777777777777777773
27414741111114741473
27373730000003737373
27777730000003777773
27373730000003737373
27515751111115751573
27777777777777777773
21111474117114741115
00000373977793730000
00000373711173730000
00000373976793730000
21111575111115751114
27777777777777777773
27414741111114741473
27373730000003737373
27777730000003777773
27373730000003737373
27515751111115751573
28777777777777777773
21111111111111111115