21411111111111111114
28377777777777779773
27374111111111117373
27373977777777777373
27373747111111147373
27373737777777737373
27373737411114737373
27373737367773737373
27373737511173737373
27773737377773737373
27373737371173737373
27373737377773737373
27373737511173737373
27373737777773737373
27373751111115737373
27373977777777937373
27375111111111737373
27377777777777777373
27371111111111111573
27777777777777777773
11111111111111111115