21111111111111111114
28777777377777777773
27417147374111711473
27379737773777977373
27517157375111711573
27777777377777777773
11114111511111111173
27773777377777777773
27373737371111111173
27373737377777777773
27773737311117111113
27373737377777777773
27373737371111111173
27373737377779777773
27373737511117111113
27373737777777777773
27373711111111111173
27373777777777777773
27375117111111711113
69377777777777777773
21111111111111111115