21111111111111111114
27777777777777777783
27999999999911111473
27777777777777777373
29999999979999999373
27777777777777777373
27999999999999997773
27977797777777799993
27979797999999797773
27979797977777797973
27979797979999997973
27979777977777777973
27779799999999999973
29999797777777977973
27777797999997977973
27999997977777777973
27777777999999997973
29999999979999999973
67777777777777777773
11111111111111111115
